1111111111111
1M010M00000C1
1M00011111001
1P0011E00C001
1111111111111