111111111111111111111111111111111111111
1000000000000000001E1000000000000000001
101111011110111100101001111011110111101
101111C1111011110010100111101111C111101
10111101111C111100101001111C1111M111101
101111011110111100101001111011110111101
100000000000000000000000000000000000001
10000000000000000000M000000000000000001
10000M000000000000000000000000000000001
101111011110111100101001111011110111101
10111101111C111100101001111C11110111101
101111C1111011110010100111101111C111101
101111011110111100101001111011110111101
1000000000000000001P1000000000000000001
111111111111111111111111111111111111111