11111111111111111111111
1P001111111111111110C01
11000111111111111100011
11100011111E11111000111
11110M01110001110M01111
11111000100000100011111
11111100000100000111111
11111110C01110C01111111
11111111111111111111111