














1111111111111111111111
1111111111111111111111
1P011111111000C0000001
10M11111111000000M0001
1001111111111111111001
1001111111111111111001
1000000000E00000000001
1M000C0000100000M00001
1111111100100111111111
1111111100100111111111
111111110M100000000001
11111111C010000M000C01
1111111111111111111111